82,69,54,55,100,6,84,37,66,64,69,19,71,22,102,116,20,20,114,113,23,84,21,101,103,99,113,54,23,80
37,86,118,1,98,115,50,49,86,67,69,1,5,64,18,87,39,20,51,20,103,69,99,114,1,17,18,19,33,49
6,19,101,23,37,23,69,102,55,32,116,96,117,1,35,22,99,34,65,86,68,54,64,85,50,113,54,49,48,39
96,19,54,96,51,116,101,85,102,22,51,82,52,82,103,51,49,81,32,87,114,86,86,97,117,112,99,0,21,37
83,87,118,20,83,16,5,103,55,32,87,102,38,49,7,36,82,96,68,66,5,118,100,116,102,3,85,32,66,65
18,66,4,3,53,32,101,68,7,86,16,21,103,48,19,97,21,50,102,48,54,67,2,119,102,97,32,36,4,87
101,20,69,101,117,115,115,50,66,102,17,6,1,119,81,103,5,86,66,3,103,119,0,69,54,113,68,7,82,0
114,85,55,6,119,18,118,32,16,32,21,7,49,18,19,33,18,98,69,112,117,53,83,38,0,38,33,98,18,98
33,49,83,37,80,1,37,65,33,5,80,67,50,68,100,66,115,53,85,117,22,33,34,116,114,99,113,35,115,19
116,18,69,7,66,116,53,36,100,50,22,17,35,118,68,99,64,34,22,66,5,102,86,117,33,83,38,54,112,38
102,81,99,39,114,64,20,64,25,19,25,115,119,102,37,48,6,103,21,102,118,50,3,114,115,38,85,99,39,119
65,67,71,32,55,7,36,96,38,117,48,68,86,3,39,65,2,52,37,85,117,49,64,83,112,83,52,18,35,21
17,0,112,68,48,37,83,119,50,2,23,82,1,35,3,22,101,85,38,115,49,17,52,1,33,53,37,81,23,6
69,1,6,71,5,36,7,103,17,54,119,17,53,67,99,84,66,97,0,118,4,83,20,33,119,85,17,53,32,22
85,0,23,36,52,96,4,102,70,82,66,19,52,71,5,53,21,51,34,64,33,64,119,65,113,17,100,23,16,100
55,115,1,87,85,119,87,53,18,113,32,70,116,48,21,80,100,64,119,6,32,82,99,53,83,34,20,85,81,3
113,33,114,21,68,98,81,65,3,52,103,67,68,82,55,84,114,3,21,85,96,7,35,102,18,32,80,118,3,20
81,3,38,36,3,37,20,53,55,6,7,33,82,114,32,48,84,97,7,23,102,18,5,48,35,97,19,39,112,37
50,115,18,4,115,103,118,3,98,50,87,68,85,118,66,38,19,96,38,4,3,34,112,98,39,54,100,33,118,70
64,96,2,3,53,118,38,100,39,49,1,53,83,69,64,85,68,53,65,85,87,97,101,99,6,4,6,39,84,81
55,48,80,64,87,5,101,38,19,50,0,37,51,20,38,49,38,55,35,114,35,7,38,84,19,38,6,49,71,86
5,4,4,5,1,85,49,117,21,38,98,96,82,99,54,100,1,101,21,49,48,22,38,98,103,51,35,18,19,112
49,32,38,99,17,2,80,49,54,65,118,38,7,1,53,70,4,69,83,2,51,53,101,52,7,119,118,68,98,67
19,4,117,7,84,4,114,4,64,0,64,66,112,100,96,35,96,100,102,64,17,52,112,1,19,103,65,102,113,54
32,16,116,1,16,32,103,2,1,84,19,82,100,5,113,101,32,96,20,7,48,16,71,80,70,80,32,87,101,65
69,117,114,102,23,87,68,71,6,69,5,118,83,96,97,55,87,34,83,37,34,114,49,35,37,50,71,101,114,32
34,7,0,117,101,87,32,83,5,113,53,16,115,82,116,113,71,50,23,102,53,0,20,54,17,117,98,54,48,97
32,3,65,7,35,17,99,22,36,34,119,38,0,65,23,33,16,112,69,85,2,98,21,71,52,71,2,83,2,23
18,4,112,34,22,112,2,53,20,113,34,84,21,69,98,98,21,52,82,39,6,102,49,6,1,0,71,53,66,54
85,115,117,113,102,82,22,87,70,54,33,5,17,99,65,103,4,18,36,48,81,85,35,17,51,33,23,7,99,86
